NO ./texture/wall.xpm
SO ./texture/wall.xpm
WE ./texture/wall.xpm
EA ./texture/wall.xpm



C 225,30,1
F 255,100,0



11111111111111111111111
10001100010001111111111
100111000010000000000111
111000000000000000000011
111011100N01011000110011
100011000001101111101111111111111111111111111111
11111010000000111111111
11111111111100001111001
11010111000010000100011
11111111111111111111111