NO ./texture/wall.xpm
SO ./texture/wall.xpm
WE ./texture/wall.xpm
EA ./texture/wall.xpm

C 225,30,1
F 255,100,0

11111111111111
1000N000000001
10000000100001
11010000000001
10001000100001
10000000000001
10000000000001
10000000000001
11111111111111