NO ./path_to_the_north_texture.xpm
SO ./path_to_the_south_texture.xpm
WE ./path_to_the_west_texture.xpm
EA ./path_to_the_east_texture.xpm


F 1,100,0
C 225,30,0


11111111111111111111111111
10000000001100000000000010001
10110000011100000000000010011
10010000000000000000000010011
11111111101100000111000010011
10000000001100000111011111011
11110111111111011100000010001
101101111111110111010100100011111111
10000000110101011100000010000N1
100000000000000011000000100011
10000000000000001101010010001
11010101110101011111011110001
  1 1 1 11101111111010111011111111
1111111 11111111111111111111111