NO texture/wall.xpm
SO ./path_to_the_south_texture.xpm
WE ./path_to_the_west_texture.xpm
EA ./path_to_the_east_texture.xpm


F 255,100,0
C 225,30,0


11111111111111111111111111111111
10001100000000000010001111111111
10011100000000000010011111111111
1000000000N000000010011111111111
11101100000111000010011111111111
10001100000111011111011111111111
11111111011100000010001111111111
11111010100100011111111111111111
11010101110000001000001111111111
11111111111111111111111111111111